1111111111111
10010000000C1
1000P11111001
100011E000011
1111111111111
