11111111111111111111111111111111111111111111111111111
1E000000000000000000000000000000000000000000000000001
10000000000000000000000000000000000000000000000000001
10000000000000000000000000000000000000000000000000001
100000000C0000000000000000000000000000000000000000001
10000000000000000000000000000000000000000000000000001
10000000000000000000000000000000000000000000000000001
10000000000000000000000000000000000000000000000000001
10000000000000000000000000000000000000000000000000001
10000000000000000000000000000000000000000000000000001
10000000000000000000000000000000000000000000000000001
10000000000000000000000000000000000C00000000000000001
10000000000000000000000000000000000000000000000000001
100000000000000000000000000000000000000010000000E0001
10000000000000000000C00000000000000000001000000000001
11111111111111111111111111111111111111111111111111111
