111111111111111111111111111111111111111
1E0000000000000000000000000000000000001
100000000000100001000000001111000000111
100000000001100000011000000000000000001
100000000C00000000111111111110000000001
1001100001100111000100C1100000000000001
100110000100000010010011000000000000001
100110000000000010010111000000000000001
100000000001110000000P01000001000000001
100000000000000000000001000001000000001
100000000011111100000001111111000E00001
10000000000000000000000110000100000C001
100000000111000000000000000001111111111
1000000001C1000000001110000000000000001
10000000000100111000C000000000000000001
111111111111111111111111111111111111111
